10 10
8 9 6 3 9 4 2 2 4 6
4 3 8 1 3 7 9 2 1 7
7 5 2 1 6 6 2 5 7 8
7 2 1 1 8 1 1 7 6 3
3 1 3 3 5 6 2 2 1 8
4 7 9 4 6 2 1 9 2 9
4 8 2 4 6 4 7 5 1 3
7 9 3 9 7 4 4 2 8 3
2 1 9 9 1 2 2 8 8 9
7 3 6 8 2 8 6 7 5 1
0 0 0
9 9 8