5 5
8 5 4 5 5
6 6 4 3 4
1 1 8 9 8
6 3 7 6 7
1 8 4 1 8
0 0 0
4 4 8