7 7
7 1 5 2 7 6 9
8 8 5 3 7 1 6
7 3 7 3 4 3 5
5 1 8 9 4 7 9
1 2 2 3 2 7 1
9 8 1 2 6 3 4
1 5 5 7 3 4 9
0 0 0
6 6 8